#####////
#...#////
#.B@#/###
#.BB#/#x#
###.###x#
/##....x#
/#...#..#
/#...####
/#####///