#######
#.....#
#..@..#
#..B..#
#..x..#
#..Q..#
#######