/####////
##..#////
#.@B#////
##B.##///
##.B.#///
#xB..#///
#xxQx#///
######///