//###////
//#x#////
//#.####/
###B.Bx#/
#x.B@###/
####B#///
///#x#///
///###///
/////////