----#####----------
----#...#----------
----#B..#----------
--###..B##---------
--#..B.B.#---------
###.#.##.#---######
#...#.##.#####..xx#
#.B..B..........xx#
#####.###.#@##..xx#
----#.....#########
----#######--------