//######/
//#....#/
###BBB.#/
#@.Bxx.#/
#.Bxxx##/
####..#//
///####//