//#####//
###..@#//
#..Bx.##/
#..xBx.#/
###.QB.#/
//#...##/
//#####//