#######
#@....#
#.....#
#..B..#
#..x..#
#..Q..#
#######