/####////
/#.@###//
/#.B..#//
###.#.##/
#x#.#..#/
#xB..#.#/
#x...B.#/
########/